4 3 3 3 3 3 3 3 3 3 3 3 3 3 3 3 4  
4 3 1 1 1 1 1 1 1 1 1 1 1 1 1 3 4
4 3 0 3 0 3 0 3 0 3 0 3 0 3 0 3 4
4 3 0 1 0 1 0 1 0 1 0 1 0 1 0 3 4
4 3 0 3 0 3 0 3 0 3 0 3 0 3 0 3 4
4 3 0 1 0 1 0 1 0 1 0 1 0 1 0 3 4
4 3 0 3 0 3 0 3 0 3 0 3 0 3 0 3 4
4 3 0 1 0 1 0 1 0 1 0 1 0 1 0 3 4
4 3 0 3 0 3 0 3 0 3 0 3 0 3 0 3 4
4 3 0 1 0 1 0 1 0 1 0 1 0 1 0 3 4 
4 3 0 3 0 3 0 3 0 3 0 3 0 3 0 3 4
4 3 0 1 0 1 0 1 0 1 0 1 0 1 0 3 4
4 3 3 3 3 3 3 3 3 3 3 3 3 3 3 3 4